{
  "last_Level": 0,
  "all_levels": 10,
  "levels": [
    {
      "moves": 30,
      "targets": [
        {
          "type": "score",
          "value": 1000
        }
      ],
      "board": [
        [0, 0, 0, 0, 0, 0, 0, 0, 0, 0],
        [0, 1, 2, 2, 3, 4, 1, 2, 3, 0],
        [0, 3, 1, 2, 1, 3, 3, 1, 4, 0],
        [0, 4, 2, 3, 2, 2, 1, 4, 2, 0],
        [0, 2, 1, 2, 3, 4, 4, 2, 3, 0],
        [0, 1, 4, 4, 2, 1, 2, 1, 2, 0],
        [0, 4, 3, 1, 3, 2, 3, 3, 1, 0],
        [0, 4, 3, 1, 4, 1, 1, 2, 1, 0],
        [0, 1, 1, 3, 2, 3, 4, 4, 3, 0],
        [0, 0, 0, 0, 0, 0, 0, 0, 0, 0]
      ]
    },
    {
      "moves": 30,
      "targets": [
        {
          "type": "score",
          "value": 1000
        }
      ],
      "board": [
        [0, 0, 0, 0, 0, 0, 0, 0, 0, 0],
        [0, 0, 0, 0, 0, 0, 0, 0, 0, 0],
        [0, 3, 1, 2, 1, 3, 3, 1, 4, 0],
        [0, 4, 2, 3, 2, 2, 1, 4, 2, 0],
        [0, 2, 1, 2, 3, 4, 4, 2, 3, 0],
        [0, 1, 4, 4, 2, 1, 2, 1, 2, 0],
        [0, 4, 3, 1, 3, 2, 3, 3, 1, 0],
        [0, 4, 3, 1, 4, 1, 1, 2, 1, 0],
        [0, 0, 0, 0, 0, 0, 0, 0, 0, 0],
        [0, 0, 0, 0, 0, 0, 0, 0, 0, 0]
      ]
    },
    {
      "moves": 30,
      "targets": [
        {
          "type": "score",
          "value": 1000
        }
      ],
      "board": [
        [0, 0, 0, 0, 0, 0, 0, 0, 0, 0],
        [0, 0, 0, 0, 0, 0, 0, 0, 0, 0],
        [0, 3, 1, 2, 1, 3, 3, 1, 4, 0],
        [0, 4, 2, 3, 2, 2, 1, 4, 2, 0],
        [0, 2, 1, 2, 3, 4, 4, 2, 3, 0],
        [0, 1, 4, 4, 2, 1, 2, 1, 2, 0],
        [0, 4, 3, 1, 3, 2, 3, 3, 1, 0],
        [0, 4, 3, 1, 4, 1, 1, 2, 1, 0],
        [0, 0, 0, 0, 0, 0, 0, 0, 0, 0],
        [0, 0, 0, 0, 0, 0, 0, 0, 0, 0]
      ]
    },
    {
      "moves": 25,
      "targets": [
        {
          "type": "score",
          "value": 2000
        }
      ],
      "board": [
        [0, 0, 0, 0, 0, 0, 0, 0, 0, 0],
        [0, 0, 0, 0, 0, 0, 0, 0, 0, 0],
        [0, 3, 1, 2, 1, 5, 3, 1, 4, 0],
        [0, 4, 2, 5, 2, 2, 1, 4, 2, 0],
        [0, 2, 1, 2, 3, 4, 4, 2, 3, 0],
        [0, 5, 4, 5, 2, 5, 2, 1, 2, 0],
        [0, 4, 3, 1, 3, 2, 3, 3, 1, 0],
        [0, 4, 5, 1, 5, 1, 1, 2, 1, 0],
        [0, 0, 0, 0, 0, 0, 0, 0, 0, 0],
        [0, 0, 0, 0, 0, 0, 0, 0, 0, 0]
      ]
    },
    {
      "moves": 25,
      "targets": [
        {
          "type": "score",
          "value": 2000
        }
      ],
      "board": [
        [0, 0, 0, 1, 2, 1, 2, 0, 0, 0],
        [0, 0, 0, 2, 1, 2, 4, 0, 0, 0],
        [0, 0, 0, 4, 3, 2, 1, 0, 0, 0],
        [0, 0, 0, 1, 3, 5, 4, 0, 0, 0],
        [0, 0, 0, 3, 4, 1, 5, 0, 0, 0],
        [0, 0, 0, 4, 5, 2, 1, 0, 0, 0],
        [0, 0, 0, 1, 2, 3, 3, 0, 0, 0],
        [0, 0, 0, 4, 1, 4, 2, 0, 0, 0],
        [0, 0, 0, 3, 5, 5, 3, 0, 0, 0],
        [0, 0, 0, 2, 3, 1, 5, 0, 0, 0]
      ]
    },
    {
      "moves": 20,
      "targets": [
        {
          "type": "remove",
          "candie": 2,
          "times": 30
        }
      ],
      "board": [
        [0, 1, 3, 4, 1, 2, 3, 4, 5, 0],
        [0, 4, 1, 2, 4, 2, 3, 1, 4, 0],
        [0, 3, 1, 2, 1, 3, 3, 1, 4, 0],
        [0, 4, 2, 3, 2, 2, 1, 4, 2, 0],
        [0, 2, 1, 2, 3, 4, 4, 2, 3, 0],
        [0, 1, 4, 4, 2, 1, 2, 1, 2, 0],
        [0, 4, 3, 1, 3, 2, 3, 3, 1, 0],
        [0, 4, 3, 1, 4, 1, 1, 2, 1, 0],
        [0, 1, 2, 1, 3, 3, 3, 2, 4, 0],
        [0, 3, 4, 2, 4, 1, 2, 3, 3, 0]
      ]
    },
    {
      "moves": 20,
      "targets": [
        {
          "type": "remove",
          "candy": 3,
          "times": 30
        }
      ],
      "board": [
        [0, 1, 3, 4, 1, 5, 3, 5, 5, 0],
        [0, 4, 1, 2, 4, 2, 3, 1, 4, 0],
        [0, 3, 5, 5, 1, 5, 5, 1, 4, 0],
        [0, 4, 2, 3, 2, 2, 5, 4, 2, 0],
        [0, 5, 5, 2, 3, 4, 4, 2, 3, 0],
        [0, 1, 4, 4, 2, 1, 2, 1, 2, 0],
        [0, 5, 3, 1, 3, 5, 3, 5, 1, 0],
        [0, 4, 3, 1, 4, 5, 1, 2, 1, 0],
        [0, 1, 2, 5, 5, 3, 5, 2, 4, 0],
        [0, 3, 4, 5, 4, 1, 2, 3, 3, 0]
      ]
    },
    {
      "moves": 15,
      "targets": [
        {
          "type": "score",
          "value": 2500
        }
      ],
      "board": [
        [0, 0, 0, 0, 0, 0, 0, 0, 0, 0],
        [0, 0, 0, 0, 0, 0, 0, 0, 0, 0],
        [0, 0, 0, 0, 0, 0, 0, 0, 0, 0],
        [0, 0, 2, 3, 2, 2, 1, 4, 0, 0],
        [0, 0, 1, 2, 3, 4, 4, 2, 0, 0],
        [0, 0, 4, 4, 2, 1, 2, 1, 0, 0],
        [0, 0, 3, 1, 3, 2, 3, 3, 0, 0],
        [0, 0, 0, 0, 0, 0, 0, 0, 0, 0],
        [0, 0, 0, 0, 0, 0, 0, 0, 0, 0],
        [0, 0, 0, 0, 0, 0, 0, 0, 0, 0]
      ]
    },
    {
      "moves": 15,
      "targets": [
        {
          "type": "score",
          "value": 2000
        }
      ],
      "board": [
        [0, 0, 0, 0, 0, 0, 0, 0, 0, 0],
        [0, 0, 0, 0, 0, 0, 0, 0, 0, 0],
        [0, 0, 0, 0, 0, 0, 0, 0, 0, 0],
        [0, 0, 2, 3, 2, 2, 5, 4, 0, 0],
        [0, 0, 5, 2, 3, 5, 4, 5, 0, 0],
        [0, 0, 5, 4, 5, 1, 5, 1, 0, 0],
        [0, 0, 3, 1, 3, 2, 3, 3, 0, 0],
        [0, 0, 0, 0, 0, 0, 0, 0, 0, 0],
        [0, 0, 0, 0, 0, 0, 0, 0, 0, 0],
        [0, 0, 0, 0, 0, 0, 0, 0, 0, 0]
      ]
    },
    {
      "moves": 20,
      "targets": [
        {
          "type": "score",
          "value": 2500
        },
        {
          "type": "remove",
          "candy": 1,
          "times": 25
        }
      ],
      "board": [
        [0, 0, 0, 0, 0, 0, 0, 0, 0, 0],
        [0, 0, 0, 0, 0, 0, 0, 0, 0, 0],
        [5, 3, 1, 5, 1, 3, 3, 1, 4, 1],
        [1, 4, 2, 3, 2, 5, 1, 4, 2, 5],
        [3, 2, 1, 5, 3, 5, 4, 2, 3, 2],
        [4, 1, 5, 4, 2, 1, 2, 1, 2, 0],
        [1, 4, 3, 5, 3, 2, 3, 3, 1, 2],
        [2, 4, 5, 1, 4, 1, 5, 5, 1, 3],
        [0, 0, 0, 0, 0, 0, 0, 0, 0, 0],
        [0, 0, 0, 0, 0, 0, 0, 0, 0, 0]
      ]
    }
  ]
}